16
16
################
#..............#
#.......########
#..............#
#......##......#
#......##......#
#..............#
######.........#
#..............#
#......####..###
#......#.......#
#......#.......#
#..............#
#......#########
#..............#
################